ad => Andorran 
ar => Argentinan 
au => Australia
bd => Bangladesh 
be => Belgium
bn => Brunei 
br => Brazil
by => Belarussia 
ca => Canadian 
ca => US & Canada
ch => Switzerland
cl => Chili   
cr => Costa Rica
cs => Czech Republic
cy => Cyprus 
de => Germany 
dk => Danish 
dz => Algeria 
ee => Estonia
eg => Egypt
es => Spain
fr => France
gp => Guadeloupe 
gw => Guinea Bissau 
hk => Hong-Kong
hr => Croatia 
hu => Hungary
il => Israel
in => India
it => Italy
jo => Jordania
mo => Macao
nl => Netherland
nz => New Zealand
pa => Panamana
ph => Philippine
pk => Pakistan   
pl => Poland
pt => Portugal
ru => Russia
se => Sweden
sg => Singapore   
sn => Senegal
ua => Ukraine   
uk => United Kingdom 
us => US 
